#############################################################
#                             # # # # # #       # #         #
####################### ### # # # # # # # # ##### ### # ### #
#   # #   #             #   #             #           # #   #
### # # ### # # ##### # ############### #####################
#           # #     # # #                                   #
################################### #########################
#     # #   #       #   #           #     #                 #
# # # # ### ### # # # # # # # ####### ##### # # ########### #
# # # #         # #   #   # #               # # #           #
# # # # ######################################### ###########
# # #   #                                                   #
########### #################################################
#                                         # # #     # #   # #
############### ########### ######### ##### # # # ### # # # #
#                         # #                   #       #   #
####### #####################################################
#   #         #                                             #
# # # ### # ######### #######################################
# #   #   #                                                 #
#############################################################