#############################################################
# # # #     # #     #           #   # #       # # # #   #   #
# # # # ##### # # # ##### ####### # # ##### ### # # # ### ###
#     #         # # #           # #   #         #   #   #   #
### ########### ############# ##### # ####### ### # ### ### #
#     #             #   # #     #   # #           #         #
##### # ### # # ### # ### ##### # ### ############### ### ###
# #   # #   # #   # #               #                   #   #
# # ### ### ##### # ################### ################### #
# # # # #   #     # # # # # #   #                     # # # #
# # # # ########### # # # # # ### ####### # # # ##### # # # #
# #   # #                 # #           # # # #     #   # # #
# # ### ####### ####### # # # # # ####### # # ######### # # #
#       #           #   #     # #       # # # #         #   #
########### ############################################# # #
#           #         # # # # #   #           # #     # # # #
########### # ### ##### # # # # # # # ######### # # # # # # #
#   #   #     #   #         # # #   # #         # # #   # # #
# ### # # # # # ### # # # # # # # # # # ### ### # # # # # # #
#     #   # # #     # # # #     # # #   #     #   # # # # # #
#############################################################