#########
#   #   #
# ### # #
#     # #
##### ###
#       #
####### #
#       #
#########