#############################################################
#                       #         #     #   #   #           #
##################### ### # # ##### # # # ##### ########### #
#                         # #       # #     # # #         # #
################### ##### ############### ### # # # # ### # #
#                       # #                 # # # # # #   # #
####################### # ############### ### # ### ####### #
#               #   # # # #             # # # # #   # #   # #
############### # # # # # ### ####### # # # # # # # # # ### #
#     # # # # # # # #   # #   #   #   #   # #   # #         #
# ##### # # # # # # # # # ### ### # # # # # # # ##### ##### #
#     # #   # # # #   # # #   #     # # #   # # # #       # #
# ##### # # # # ####### # ############### ### # # # # # # # #
#       # #   # #       # #       #     #   # #     # # # # #
##### # ### # # # ####### # ####### ### ### # ####### #######
# #   #     #   #     # # #         #       #   # #         #
# ### # # ### # ##### # # ########### ######### # ##### # ###
#     # #   # #         # #                 #   #       #   #
##################### ################### ######### #########
#                         #                                 #
#############################################################