#######
# #   #
# ### #
#     #
# ### #
# #   #
#######