#############
# #   #     #
# # # # ### #
# # #   #   #
# ##### #####
# # #   #   #
# # # # ### #
#     # #   #
# ### ##### #
# # # #     #
# # # # ### #
# #     #   #
#############