#############################################################
#   #   # #       #         #             #     # #       # #
# # ### # # # # ### # # # # # ### ##### # # ##### ### ##### #
# #         # #     # # # #   #     #   #         # #   # # #
############### ################################### # # # # #
# #     #       #   #   # # #   #   #             #   #   # #
# ### ### # ### # ### ### # ### ### ### ### ### # # # # # # #
# #     # #   #   # #                     #   # # # # # # # #
# # ### ####### # # ####### ######################### # # # #
#   #           #           #   #       # #       #   # #   #
### ##################### # # # # ### ### # # # ### # # # # #
# #     #     # # # # #   #   #   #     # # # # # # # # # # #
# # # # # # ### # # # ### ####### ### ### # ### # # # # # # #
#   # #   #     #   #     #     # #     # # # # #   # # # # #
# ### # # # ##### # ### ### # ### ### # # # # # # # # # # # #
#   # # # #     # # #     # #     #   #       #   # # # # # #
### ############### ######### ####################### # # # #
#     # #           #   #         #   # #         #   # # # #
# ### # # ### # # # # ### ##### # # # # # # # # # # # # # # #
# #         # # # # #         # #   #     # # # # # # # # # #
#############################################################